**************************************************
*******                              ******** ****
******* ************** ************* ******** ****
******* ************** ***         * ***      ****
P       ************** **  ******  * *** **** ****
******* ***         ** *  *******        **** ****
******* *** ******* ** * ******************** ****
******* *** ******* **   ******************** ****
******* *** ******* ************************* ****
******* *** **                      ********* ****
***     *** ** **** **** ******************** ****
*** ********** **** ****               ****** ****
*** ********** **** ************************* ****
*** ********** **** ************************* ****
***            **** ******** **************** ****
******* *********** ******** **************** ****
******* *********** ********      *********** ****
*******       ***** ******** **** *********** ****
*******************          **** *********** ****
********************************* *********** ****
********************************* ****************
*********************************                T
**************************************************
